00000000000000
00000000000000
00000000000000
00000000000000
00000000000000
00000000000000
22222230342222
11111111111111
11111111111111
11111111111111
11111111111111