00000000000000
00000000000000
00000000000000
00000000000000
00000000000000
00000000000000
22222230822222
11111111111111
11111111111111
11111111111111
11111111111111