00000000000000
00000000000000
00000000000000
00000000000000
00000000000000
00000000000000
22222230042222
11111113411111
11111111111111
11111111111111
11111111111111