00000000000000
00000000000000
00000000000000
00000000000000
00000000000000
00000000000000
22223000042222
11111300411111
11111111111111
11111111111111
11111111111111